[
  {
    "type": "mapgen",
    "method": "json",
    "om_terrain": [ "brit_military_base" ],
    "weight": 100,
    "object": {
      "fill_ter": "t_floor",
      "rows": [
        ",,,,,,,,,,,,,,,,,,,,,,,,",
        ",,,,,,,,,,,,,,,,,,,,,,,,",
        ",,|-FFFFFFFFFFF-|,,,,,,,",
        ",,|.............|,,,,,,,",
        ",,|.....&.......|,,,,,,,",
        ",,|.............|,,,,,,,",
        ",,|...........D.|,,,,,,,",
        ",,|-+-------+-|+|,,,,,,,",
        ",,|l.........|r|,,,,,,,",
        ",,|l.........|r|,,,,,,,",
        ",,|l.........|r|,,,,,,,",
        ",,|l.........|r|,,,,,,,",
        ",,|l.........|r|,,,,,,,",
        ",,|l.........|r|,,,,,,,",
        ",,|-+-------+-|,,,,,,,",
        ",,|.............|,,,,,,,",
        ",,|.............|,,,,,,,",
        ",,|.....&.......|,,,,,,,",
        ",,|.............|,,,,,,,",
        ",,|.............|,,,,,,,",
        ",,|-FFFFFFFFFFF-|,,,,,,,",
        ",,,,,,,,,,,,,,,,,,,,,,,,",
        ",,,,,,,,,,,,,,,,,,,,,,,,",
        ",,,,,,,,,,,,,,,,,,,,,,,,"
      ],
      "palettes": [ "standard_domestic_palette" ],
      "terrain": { ",": [ "t_grass", "t_grass", "t_grass", "t_dirt" ], "F": "t_chainlink_fence", "D": "t_chainlink_door" },
      "furniture": { "&": "f_table", "l": "f_locker", "r": "f_rack" },
      "place_loot": [
        { "group": "brit_military_guns", "x": [ 3, 4 ], "y": [ 8, 13 ], "chance": 70, "repeat": [ 1, 3 ] },
        { "group": "brit_military_armor", "x": [ 3, 4 ], "y": [ 8, 13 ], "chance": 80, "repeat": [ 2, 4 ] },
        { "group": "brit_military_basic", "x": [ 17, 18 ], "y": [ 8, 13 ], "chance": 75, "repeat": [ 2, 5 ] },
        { "group": "office", "x": [ 7, 11 ], "y": [ 3, 5 ], "chance": 60, "repeat": [ 1, 2 ] },
        { "group": "office", "x": [ 7, 11 ], "y": [ 16, 19 ], "chance": 60, "repeat": [ 1, 2 ] }
      ],
      "place_monsters": [ { "monster": "GROUP_BRITISH_MILITARY_ZOMBIES", "x": [ 3, 20 ], "y": [ 3, 19 ], "chance": 60, "repeat": [ 2, 4 ] } ],
      "place_npcs": [
        { "class": "brit_soldier", "x": 5, "y": 12 },
        { "class": "brit_soldier", "x": 8, "y": 11 },
        { "class": "brit_soldier", "x": 8, "y": 14 },
        { "class": "brit_soldier", "x": 15, "y": 12 },
        { "class": "brit_officer", "x": 18, "y": 13 },
        { "class": "brit_sas", "x": 15, "y": 21 },
        { "class": "brit_sas", "x": 10, "y": 20 }
      ]
    }
  }
]
