[
  {
    "type": "mapgen",
    "method": "json",
    "om_terrain": [ "brit_military_hq" ],
    "weight": 100,
    "object": {
      "fill_ter": "t_floor",
      "rows": [
        "FFFFFFFFFFFFFFFFFFFFFFFFFF",
        "F,,,,,,,,,,,,,,,,,,,,,,,,F",
        "F,,|----|----|----|,,,,,,F",
        "F,,|llll|....|llll|,,,,,,F",
        "F,,|l..l|....|l..l|,,,,,,F",
        "F,,|l..l|....|l..l|,,,,,,F",
        "F,,|----|----|----|,,,,,,F",
        "F,,,,,,,,,,,,,,,,,,,,,,,,,F",
        "F,,,,,,,,,,,,,,,,,,,,,,,,,F",
        "F,,|-------|----------|,,F",
        "F,,|........|..........|,,F",
        "F,,|........|..........|,,F",
        "F,,|....&...|.....&....|,,F",
        "F,,|........|..........|,,F",
        "F,,|........|..........|,,F",
        "F,,|--------|----------|,,F",
        "F,,,,,,,,,,,,,,,,,,,,,,,,,F",
        "F,,,,,,,,,,,,,,,,,,,,,,,,,F",
        "F,,|------|--------|,,,,,F",
        "F,,|......|........|,,,,,F",
        "F,,|.rrrr.|........|,,,,,F",
        "F,,|.rrrr.|...&....|,,,,,F",
        "F,,|......|........|,,,,,F",
        "F,,|------|--------|,,,,,F",
        "F,,,,,,,,,,,,,,,,,,,,,,,,,F",
        "F,,,,,,,,,,,,,,,,,,,,,,,,,F",
        "F,,|------|--------|,,,,,F",
        "F,,|......|........|,,,,,F",
        "F,,|......|........|,,,,,F",
        "F,,|..&&..|...&&...|,,,,,F",
        "F,,|......|........|,,,,,F",
        "F,,|......|........|,,,,,F",
        "F,,|------|--------|,,,,,F",
        "F,,,,,,,,,,,,,,,,,,,,,,,,,F",
        "F,,,,,,,,,,,,,,,,,,,,,,,,,F",
        "FFFFF--D--F--------FFFFFF"
      ],
      "palettes": [ "standard_domestic_palette" ],
      "terrain": { ",": [ "t_grass", "t_grass", "t_grass", "t_dirt" ], "F": "t_chainlink_fence", "D": "t_chainlink_door" },
      "furniture": { "&": "f_table", "l": "f_locker", "r": "f_rack" },
      "place_loot": [
        { "group": "brit_military_clothing_locker", "x": [ 3, 6 ], "y": [ 3, 5 ], "chance": 90, "repeat": [ 3, 6 ] },
        { "group": "brit_military_clothing_locker", "x": [ 17, 20 ], "y": [ 3, 5 ], "chance": 90, "repeat": [ 3, 6 ] },
        { "group": "brit_military_weapons_locker", "x": [ 4, 7 ], "y": [ 20, 21 ], "chance": 80, "repeat": [ 2, 4 ] },
        { "group": "office", "x": [ 8, 9 ], "y": [ 12, 12 ], "chance": 70, "repeat": [ 1, 2 ] },
        { "group": "office", "x": [ 16, 17 ], "y": [ 12, 12 ], "chance": 70, "repeat": [ 1, 2 ] },
        { "group": "office", "x": [ 14, 15 ], "y": [ 21, 21 ], "chance": 70, "repeat": [ 1, 2 ] },
        { "group": "office", "x": [ 8, 9 ], "y": [ 29, 29 ], "chance": 70, "repeat": [ 1, 2 ] },
        { "group": "office", "x": [ 16, 17 ], "y": [ 29, 29 ], "chance": 70, "repeat": [ 1, 2 ] },
        { "group": "brit_military_basic", "x": [ 3, 20 ], "y": [ 10, 14 ], "chance": 40, "repeat": [ 2, 4 ] },
        { "group": "brit_military_elite", "x": [ 8, 18 ], "y": [ 19, 22 ], "chance": 30, "repeat": [ 1, 2 ] },
        { "group": "brit_sas_locker", "x": [ 8, 18 ], "y": [ 19, 22 ], "chance": 70, "repeat": [ 2, 4 ] },
        { "group": "brit_military_basic", "x": [ 3, 20 ], "y": [ 27, 31 ], "chance": 40, "repeat": [ 2, 4 ] }
      ],
      "place_npcs": [
        { "class": "brit_soldier", "x": 5, "y": 12 },
        { "class": "brit_soldier", "x": 8, "y": 11 },
        { "class": "brit_soldier", "x": 8, "y": 14 },
        { "class": "brit_soldier", "x": 5, "y": 29 },
        { "class": "brit_soldier", "x": 8, "y": 28 },
        { "class": "brit_officer", "x": 15, "y": 12 },
        { "class": "brit_officer", "x": 18, "y": 13 },
        { "class": "brit_officer", "x": 15, "y": 29 },
        { "class": "brit_sas", "x": 15, "y": 21 },
        { "class": "brit_sas", "x": 10, "y": 20 },
        { "class": "brit_raf_pilot", "x": 18, "y": 29 }
      ]
    }
  }
]
