[
  {
    "type": "mapgen",
    "method": "json",
    "om_terrain": [ "brit_supply_depot" ],
    "object": {
      "fill_ter": "t_floor",
      "rows": [
        "........................",
        "........................",
        "..|-WWWWWWWWWWWWWWW-|..",
        "..|.................|..",
        "..|.rrrrr..rrrrr....|..",
        "..|.rrrrr..rrrrr....|..",
        "..|.rrrrr..rrrrr....|..",
        "..|.................|..",
        "..|.ccccc..ccccc....|..",
        "..|.ccccc..ccccc....|..",
        "..|.ccccc..ccccc....|..",
        "..|.................|..",
        "..|-----|+|--------|..",
        "..|.................|..",
        "..|.....&.&.&.......|..",
        "..|.................|..",
        "..|.................|..",
        "..|-----|+|--------|..",
        "..|l.l.l.|.|.l.l.l..|..",
        "..|l.l.l.|.|.l.l.l..|..",
        "..|l.l.l.|.|.l.l.l..|..",
        "..|-----|+|--------|..",
        "..|.................|..",
        "..|-WWWWWWWWWWWWWWW-|.."
      ],
      "palettes": [ "standard_domestic_palette" ],
      "terrain": { ".": [ "t_grass", "t_grass", "t_grass", "t_dirt" ], "W": "t_window_boarded" },
      "furniture": { "&": "f_table", "l": "f_locker", "c": "f_crate_c", "r": "f_rack" },
      "place_loot": [
        { "group": "brit_military_clothing_locker", "x": [ 4, 18 ], "y": [ 4, 6 ], "chance": 90, "repeat": [ 5, 10 ] },
        { "group": "brit_military_weapons_locker", "x": [ 4, 18 ], "y": [ 8, 10 ], "chance": 80, "repeat": [ 3, 6 ] },
        { "group": "brit_military_basic", "x": [ 9, 11 ], "y": [ 14, 14 ], "chance": 80, "repeat": [ 1, 3 ] },
        { "group": "brit_military_basic", "x": [ 4, 6 ], "y": [ 18, 20 ], "chance": 70, "repeat": [ 3, 6 ] },
        { "group": "brit_military_elite", "x": [ 14, 18 ], "y": [ 18, 20 ], "chance": 70, "repeat": [ 3, 6 ] },
        { "group": "office", "x": [ 4, 18 ], "y": [ 14, 16 ], "chance": 60, "repeat": [ 1, 3 ] }
      ],
      "place_npcs": [
        { "class": "brit_quartermaster", "x": 10, "y": 14 },
        { "class": "brit_soldier", "x": 4, "y": 14 },
        { "class": "brit_soldier", "x": 18, "y": 14 },
        { "class": "brit_soldier", "x": 4, "y": 5 },
        { "class": "brit_soldier", "x": 18, "y": 5 }
      ]
    }
  }
]
