[
  {
    "type": "mapgen",
    "method": "json",
    "om_terrain": [ "basement" ],
    "weight": 500,
    "object": {
      "fill_ter": "t_rock",
      "rotation": [ 0, 3 ],
      "rows": [
        "                        ",
        "                        ",
        "                        ",
        "   |----------------|   ",
        "   |................|   ",
        "   |.===..=%%=..===.|   ",
        "   |.X.=..=..=..=.%.|   ",
        "   |.%.=..====..=.%.|   ",
        "   |.===........===.|   ",
        "   |................|   ",
        "   |.===.R|--|R.===.|   ",
        "   |.%.=.R|<<|R.=.%.|   ",
        "   |.%.=.R|..|R.=.%.|   ",
        "   |.===.R|++|R.===.|   ",
        "   |................|   ",
        "   |.===........===.|   ",
        "   |.%.=..====..=~=.|   ",
        "   |.%.=..=..=..=~=.|   ",
        "   |.===..=%%=..===.|   ",
        "   |................|   ",
        "   |----------------|   ",
        "                        ",
        "                        ",
        "                        "
      ],
      "terrain": {
        ".": "t_rock_floor",
        "R": "t_rock_floor",
        "~": "t_sewage",
        "=": "t_wall_glass",
        "%": "t_door_glass_c",
        "X": "t_door_glass_o",
        "<": "t_stairs_up",
        "+": "t_door_c",
        "-": "t_wall",
        "|": "t_wall"
      },
      "furniture": { "R": "f_rack" },
      "place_loot": [
        { "group": "pet_supplies", "x": 9, "y": [ 10, 13 ], "chance": 80, "repeat": [ 1, 8 ] },
        { "group": "pet_food", "x": 14, "y": [ 10, 11 ], "chance": 80, "repeat": [ 1, 4 ] },
        { "group": "pet_medicine", "x": 14, "y": [ 12, 13 ], "chance": 80, "repeat": [ 1, 4 ] }
      ],
      "place_monsters": [
        { "monster": "GROUP_PETS_MAMMALS", "x": 6, "y": [ 6, 7 ], "repeat": 2 },
        { "monster": "GROUP_PETS_MAMMALS", "x": 6, "y": [ 11, 12 ], "repeat": 2 },
        { "monster": "GROUP_PETS_MAMMALS", "x": 6, "y": [ 16, 17 ], "repeat": 2 },
        { "monster": "GROUP_PETS_INSECTS", "x": 17, "y": [ 6, 7 ], "repeat": 2 },
        { "monster": "GROUP_PETS_INSECTS", "x": 17, "y": [ 11, 12 ], "repeat": 2 },
        { "monster": "GROUP_PETS_FISH", "x": 17, "y": [ 16, 17 ], "repeat": 2 },
        { "monster": "GROUP_PETS_HERPS", "x": [ 11, 12 ], "y": 6, "repeat": 2 },
        { "monster": "GROUP_PETS_HERPS", "x": [ 11, 12 ], "y": 17, "repeat": 2 }
      ]
    }
  }
]
