[
  {
    "method": "json",
    "weight": 300,
    "object": {
      "fill_ter": "t_rock_floor",
      "rows": [
        ";;;;;;;;;;;;;;;;;;;;;;;;;;;;;;;;;;;;;;;;;;;;;;;;;;;;;;;;;;;;;;;;;;;;;;;;",
        ";;;;;;;;;;;;;;;;;;;;;;;..........+++++..........;;;;;;;;;;;;;;;;;;;;;;;;",
        ";;;;;;;;;;;;;;;;;;;;;;...........+++++...........;;;;;;;;;;;;;;;;;;;;;;;",
        ";;;;;;;;;;;;;;;;;;;;;.............+++.............;;;;;;;;;;;;;;;;;;;;;;",
        ";;;;;;;;;;;;;;;;;;;;..............+++..............;;;;;;;;;;;;;;;;;;;;;",
        ";;;;;;;;;;;;;;;;;;;...............+++...............;;;;;;;;;;;;;;;;;;;;",
        ";;;;;;;;;;;;;;;;;;.................+.................;;;;;;;;;;;;;;;;;;;",
        ";;;;;;;;;;;;;;;;;..................+..................;;;;;;;;;;;;;;;;;;",
        ";;;;;;;;;;;;;;;;...................+...................;;;;;;;;;;;;;;;;;",
        ";;;;;;;;;;;;;;;....................+....................;;;;;;;;;;;;;;;;",
        ";;;;;;;;;;;;;;.....................+.....................;;;;;;;;;;;;;;;",
        ";;;;;;;;;;;;;......................+......................;;;;;;;;;;;;;;",
        ";;;;;;;;;;;;.......................+.......................;;;;;;;;;;;;;",
        ";;;;;;;;;;;........................+........................;;;;;;;;;;;;",
        ";;;;;;;;;;.........................+.........................;;;;;;;;;;;",
        ";;;;;;;;;..........................+..........................;;;;;;;;;;",
        ";;;;;;;;...........................+...........................;;;;;;;;;",
        ";;;;;;;............................+............................;;;;;;;;",
        ";;;;;;.............................+.............................;;;;;;;",
        ";;;;;..............................+..............................;;;;;;",
        ";;;;..............................'+'..............................;;;;;",
        ";;;..............................''+''..............................;;;;",
        ";;..............................'''+'''..............................;;;",
        ";..............................''''+''''..............................;;",
        ";.............................'''''+'''''.............................;;",
        ";............................'''''-+-'''''............................;;",
        ";...........................'''''--+--'''''...........................;;",
        ";..........................'''''---+---'''''..........................;;",
        ";.........................'''''----+----'''''.........................;;",
        ";........................'''''----+++----'''''........................;;",
        ";.......................'''''----++=++----'''''.......................;;",
        ";......................'''''----++===++----'''''......................;;",
        ";.....................'''''----++==K==++----'''''.....................;;",
        ";++..................'''''----++=======++----'''''..................++;;",
        ";+++++..............'''''----++=========++----'''''..............+++++;;",
        ";+++++++++++++++++++++++++++++==K==O==K==+++++++++++++++++++++++++++++;;",
        ";+++++..............'''''----++=========++----'''''..............+++++;;",
        ";++..................'''''----++=======++----'''''..................++;;",
        ";.....................'''''----++==K==++----'''''.....................;;",
        ";......................'''''----++===++----'''''......................;;",
        ";.......................'''''----++=++----'''''.......................;;",
        ";........................'''''----+++----'''''........................;;",
        ";.........................'''''----+----'''''.........................;;",
        ";..........................'''''---+---'''''..........................;;",
        ";...........................'''''--+--'''''...........................;;",
        ";............................'''''-+-'''''............................;;",
        ";.............................'''''+'''''.............................;;",
        ";..............................''''+''''..............................;;",
        ";;..............................'''+'''..............................;;;",
        ";;;..............................''+''..............................;;;;",
        ";;;;..............................'+'..............................;;;;;",
        ";;;;;..............................+..............................;;;;;;",
        ";;;;;;.............................+.............................;;;;;;;",
        ";;;;;;;............................+............................;;;;;;;;",
        ";;;;;;;;...........................+...........................;;;;;;;;;",
        ";;;;;;;;;..........................+..........................;;;;;;;;;;",
        ";;;;;;;;;;.........................+.........................;;;;;;;;;;;",
        ";;;;;;;;;;;........................+........................;;;;;;;;;;;;",
        ";;;;;;;;;;;;.......................+.......................;;;;;;;;;;;;;",
        ";;;;;;;;;;;;;......................+......................;;;;;;;;;;;;;;",
        ";;;;;;;;;;;;;;.....................+.....................;;;;;;;;;;;;;;;",
        ";;;;;;;;;;;;;;;....................+....................;;;;;;;;;;;;;;;;",
        ";;;;;;;;;;;;;;;;...................+...................;;;;;;;;;;;;;;;;;",
        ";;;;;;;;;;;;;;;;;..................+..................;;;;;;;;;;;;;;;;;;",
        ";;;;;;;;;;;;;;;;;;.................+.................;;;;;;;;;;;;;;;;;;;",
        ";;;;;;;;;;;;;;;;;;;...............+++...............;;;;;;;;;;;;;;;;;;;;",
        ";;;;;;;;;;;;;;;;;;;;..............+++..............;;;;;;;;;;;;;;;;;;;;;",
        ";;;;;;;;;;;;;;;;;;;;;.............+++.............;;;;;;;;;;;;;;;;;;;;;;",
        ";;;;;;;;;;;;;;;;;;;;;;...........+++++...........;;;;;;;;;;;;;;;;;;;;;;;",
        ";;;;;;;;;;;;;;;;;;;;;;;..........+++++..........;;;;;;;;;;;;;;;;;;;;;;;;",
        ";;;;;;;;;;;;;;;;;;;;;;;;;;;;;;;;;;;;;;;;;;;;;;;;;;;;;;;;;;;;;;;;;;;;;;;;",
        ";;;;;;;;;;;;;;;;;;;;;;;;;;;;;;;;;;;;;;;;;;;;;;;;;;;;;;;;;;;;;;;;;;;;;;;;"
      ],
      "terrain": {
        "O": "t_dmbb_abode",
        ".": "t_uniqmazing_fl_yellow",
        "'": "t_uniqmazing_fl_yellow",
        "-": "t_uniqmazing_fl_yellow",
        "=": "t_uniqmazing_fl_azurblue",
        "K": "t_uniqmazing_fl_azurblue",
        ";": "t_uniqmazing_wl_yellow",
        "+": "t_uniqmazing_fl_black"
      },
      "furniture": { "K": "f_brazier" },
      "place_npcs": [ { "class": "dmbb_npc_orb", "x": 35, "y": 35 } ]
    },
    "om_terrain": [
      [ "dmbb_arena_3", "dmbb_arena_2", "dmbb_arena_1" ],
      [ "dmbb_arena_6", "dmbb_arena_5", "dmbb_arena_4" ],
      [ "dmbb_arena_9", "dmbb_arena_8", "dmbb_arena_7" ]
    ],
    "type": "mapgen"
  }
]
