[
  {
    "type": "mapgen",
    "method": "json",
    "om_terrain": [ "trailer_park_1" ],
    "weight": "1 g",
    "object": {
      "fill_ter": "t_grass",
      "rows": [
        "..........dddd..........",
        "...dddddb.dddd..bddddd..",
        "...dddddb.dddd..bddddd..",
        "...dddddb.dddd..bddddd..",
        "...dddddb.d.dd..bddddd..",
        "...ddddddddddd..bddddd..",
        "...dddddb.dddddddddddd..",
        "...dddddb.dd.d..bddddd..",
        "...dddddb.dddd..bddddd..",
        "...dddddb.d.dd..bddddd..",
        "...dddddb.dddd..bddddd..",
        "........b.dddd..b.......",
        "........b.dd.d..b.......",
        "...dddddb.dddd..bddddd..",
        "...dddddb.dddd..bddddd..",
        "...dddddb.dddd..bddddd..",
        "...dddddb.dd.d..bddddd..",
        "...ddddddddddd..bddddd..",
        "...dddddb.dddddddddddd..",
        "...dddddb.dddd..bddddd..",
        "...dddddb.dddd..bddddd..",
        "...dddddb.d.dd..bddddd..",
        "...dddddb.dddd..bddddd..",
        "..........dddd.........."
      ],
      "set": [  ],
      "terrain": {
        ".": "t_grass",
        "d": "t_dirt",
        "-": "t_wall",
        "|": "t_wall",
        "+": "t_door_c",
        "'": "t_floor",
        "v": "t_window_domestic",
        "b": "t_shrub"
      },
      "furniture": { "D": "f_trashcan", "s": "f_sink", "t": "f_toilet", "S": "f_shower" },
      "toilets": { "t": {  } },
      "place_loot": [  ],
      "place_monsters": [ { "monster": "GROUP_ZOMBIE", "x": [ 2, 12 ], "y": [ 2, 12 ], "chance": 2 } ],
      "place_vehicles": [
        { "vehicle": "grei_mobile_home", "x": 5, "y": 6, "chance": 75, "rotation": 270 },
        { "vehicle": "grei_mobile_home", "x": 19, "y": 5, "chance": 75, "rotation": 90 },
        { "vehicle": "grei_mobile_home", "x": 19, "y": 17, "chance": 75, "rotation": 90 },
        { "vehicle": "grei_mobile_home", "x": 5, "y": 18, "chance": 75, "rotation": 270 }
      ]
    }
  },
  {
    "type": "mapgen",
    "method": "json",
    "om_terrain": [ "trailer_park_2" ],
    "weight": "1 g",
    "object": {
      "fill_ter": "t_floor",
      "rows": [
        "----V----.dddd.---------",
        "|S'+'+'S|.dddd.|''t|t''|",
        "|---'---|.dd.d.|'--|--'|",
        "|S'+'+'S|.dddd.|''t|t''|",
        "|---'---|.dddd.|'--|t''|",
        "|S'+'+'S|.d.dd.|''s|s''|",
        "|---'---|.dddd.|'-----'|",
        "|S'+'+'S|.dd.d.|'''''''|",
        "|---+---|.dddd.|---+---|",
        "....d....dddddd....d....",
        "dddddddddddddddddddddddd",
        "dddd.ddddddddddd.ddddddd",
        "dd.ddddddddddddddddd.ddd",
        "dddddddddddddddddddddddd",
        ".........dddddd..d......",
        "..W-----bddddd.|V+VVVV|P",
        "...|D'''dddddd.|''cTcT|.",
        "d..|&'c'b.dddd.|''''''|.",
        "...|'cT'b.dddd.V'''|--|.",
        ".d.|2'c'b.d.dd.|CC'|KK|.",
        "...|1'''dddddd.|c''|'c|.",
        "...-----b.dddd.|'''+''V.",
        "..d....d..dddd.|------|.",
        "......d...dddd.........."
      ],
      "set": [  ],
      "terrain": {
        ".": "t_grass",
        "d": "t_dirt",
        "-": "t_wall",
        "|": "t_wall",
        "+": "t_door_c",
        "'": "t_floor",
        "V": "t_window_no_curtains",
        "b": "t_shrub",
        "&": "t_atm",
        "W": "t_water_pump"
      },
      "furniture": {
        "D": "f_trashcan",
        "s": "f_sink",
        "t": "f_toilet",
        "S": "f_shower",
        "c": "f_chair",
        "T": "f_table",
        "C": "f_counter",
        "K": "f_desk"
      },
      "toilets": { "t": {  } },
      "vendingmachines": { "1": { "item_group": "vending_drink" }, "2": { "item_group": "vending_food" } },
      "signs": { "P": { "signage": "Lot rent due 1st of every month.  No exceptions." } },
      "place_loot": [  ],
      "place_monsters": [ { "monster": "GROUP_ZOMBIE", "x": [ 14, 15 ], "y": [ 14, 15 ], "chance": 3 } ]
    }
  }
]
