[
  {
    "method": "json",
    "weight": 300,
    "object": {
      "rows": [
        "........................",
        "........................",
        "........................",
        "........................",
        "........................",
        "........................",
        "........................",
        "........................",
        "..........ooo...........",
        ".........ooPoo..........",
        "........ooPPPoo.........",
        "........oPPpPPo.........",
        "........ooPPPoo.........",
        ".........ooPoo..........",
        "..........ooo...........",
        "..........ooo...........",
        "..........ooo...........",
        "..........ooo...........",
        "..........ooo...........",
        "..........ooo...........",
        "..........ooo...........",
        "..........ooo...........",
        "..........ooo...........",
        "..........ooo..........."
      ],
      "terrain": { "P": "t_elevator", "p": "t_dmbb_warpgate", "o": "t_uniqmazing_fl_black", ".": "t_uniqmazing_wl_black" }
    },
    "om_terrain": [ "dmbb_warpgate" ],
    "type": "mapgen"
  }
]
