[
  {
    "type": "mapgen",
    "method": "json",
    "om_terrain": [ "construction_site" ],
    "weight": 100,
    "obiect": {
      "fill_ter": "t_floor",
      "rows": [
        "                        ",
        "  bbbbbbbbbbfffbbbbbbbb ",
        "  b                   b ",
        "  bcccc hhghhghhhghhh b ",
        "  bcccc hgggggggggggh b ",
        "  bccc  hgggggggggggh b ",
        "  bcc   ggggggggggggh b ",
        "  b     ggggggggggggg b ",
        "  b     hgggggggggggh b ",
        "  b     hhhhhgggggggh b ",
        "  b         hgggggggh b ",
        "  b         ggggggggg b ",
        "  b         hgggggggh b ",
        "  b         hgggggggh b ",
        "  b         hgggggggh b ",
        "  b         ggggggggh b ",
        "  b         ggggggggg b ",
        "  b  i   i  hgggggggh b ",
        "  f  ii iii hgggggggh b ",
        "  f iii  i  hhhhhhhhh b ",
        "  b                   b ",
        "  bbbbbbbbbbbbbbbbbbbbb ",
        "                        ",
        "                        "
      ],
      "terrain": {
        " ": "t_region_groundcover_urban",
        "b": "t_chainfence_v",
        "c": "t_dirtmound",
        "e": "t_pit",
        "f": "t_chaingate_l",
        "g": "t_concrete",
        "h": "t_concrete_wall",
        "i": "t_dirt",
        "i": "t_dirt",
        "k": "t_dirt",
        "m": "t_dirt"
      },
      "furniture": { "i": "f_rubble", "i": "f_rubble_rock", "k": "f_sign" },
      "signs": { "k": { "signage": "Caution: hard hats required in this area" } },
      "place_loot": [
        { "group": "hardware_bulk", "chance": 60, "repeat": [ 0, 3 ], "x": [ 3, 6 ], "y": [ 3, 6 ] },
        { "group": "supplies_electronics", "chance": 50, "repeat": [ 1 ], "x": [ 9, 9 ], "y": [ 8, 7 ] },
        { "group": "supplies_electronics", "chance": 50, "repeat": [ 1 ], "x": [ 11, 11 ], "y": [ 19, 18 ] },
        { "group": "hardware_bulk", "chance": 60, "repeat": [ 0, 3 ], "x": [ 3, 3 ], "y": [ 14, 15 ] },
        { "group": "hardware_bulk", "chance": 60, "repeat": [ 0, 3 ], "x": [ 4, 4 ], "y": [ 14, 15 ] },
        { "group": "hardware_bulk", "chance": 60, "repeat": [ 0, 3 ], "x": [ 5, 5 ], "y": [ 14, 15 ] },
        { "group": "hardware_bulk", "chance": 60, "repeat": [ 0, 3 ], "x": [ 6, 6 ], "y": [ 14, 15 ] },
        { "group": "hardware_trash", "chance": 60, "repeat": [ 0, 2 ], "x": [ 13, 18 ], "y": [ 0, 2 ] },
        { "group": "hardware_trash", "chance": 60, "repeat": [ 0, 2 ], "x": [ 3, 21 ], "y": [ 20, 20 ] },
        { "group": "hardware_trash", "chance": 60, "repeat": [ 0, 2 ], "x": [ 21, 21 ], "y": [ 19, 5 ] },
        { "group": "hardware_clothing", "chance": 50, "repeat": [ 1 ], "x": [ 14, 16 ], "y": [ 4, 4 ] },
        { "group": "hardware_clothing", "chance": 50, "repeat": [ 1 ], "x": [ 18, 19 ], "y": [ 4, 5 ] },
        { "group": "hardware_plumbing", "chance": 60, "repeat": [ 0, 2 ], "x": [ 13, 11 ], "y": [ 9, 18 ] },
        { "group": "hardware_bulk", "chance": 80, "repeat": [ 1, 3 ], "x": [ 9, 14 ], "y": [ 2, 4 ] },
        { "group": "hardware_bulk", "chance": 80, "repeat": [ 1, 3 ], "x": [ 20, 19 ], "y": [ 6, 12 ] },
        { "group": "hardware_bulk", "chance": 80, "repeat": [ 1, 3 ], "x": [ 20, 18 ], "y": [ 18, 15 ] },
        { "group": "hardware_bulk", "chance": 80, "repeat": [ 1, 3 ], "x": [ 14, 12 ], "y": [ 18, 10 ] },
        { "group": "hardware_bulk", "chance": 80, "repeat": [ 1, 3 ], "x": [ 7, 11 ], "y": [ 10, 15 ] },
        { "group": "hardware_bulk", "chance": 100, "repeat": [ 2, 5 ], "x": [ 3, 6 ], "y": [ 8, 12 ] },
        { "group": "hardware_trash", "chance": 60, "repeat": [ 0, 2 ], "x": [ 4, 6 ], "y": [ 17, 19 ] },
        { "group": "hardware_trash", "chance": 60, "repeat": [ 0, 2 ], "x": [ 8, 10 ], "y": [ 17, 19 ] }
      ],
      "place_vehicles": [ { "vehicle": "small_utility_vehicles", "x": 17, "y": 2, "chance": 50, "fuel": 20, "status": 0, "rotation": 270 } ]
    }
  }
]
