[
  {
    "type": "mapgen",
    "method": "json",
    "om_terrain": [ "house" ],
    "weight": 100,
    "object": {
      "fill_ter": "t_floor",
      "rows": [
        "zzzzzzzzzzzzzzzzzzzzzzzz",
        "    ttttttttttttttttt   ",
        "           tt           ",
        "   |-gggg-|_L|---gg-|   ",
        "   |RooooR|oo|oooooo|   ",
        "   |oooooH|ooIoooooo|   ",
        "   |NooooH|oo|hffhoJ|   ",
        "   |sooooH|oo|oooooS|   ",
        "   |soooooLoo|JFJOnJ|   ",
        "   |RRRRRR|oo|------|   ",
        "   |----/-|oo/9bbBB|    ",
        "   |UUUooo|oo|ooooog    ",
        "   |U ooooIoo|oSopo|    ",
        "   |Uooooo-|L|-----|    ",
        "   |ooooooo|ooDDLDD|    ",
        "   |ooooooo|ooooooog    ",
        "   |-ggLgg-|ooooooog    ",
        "   ~   t   |ooooooC|    ",
        "   ~  ttt  |dooo@@@|    ",
        "   ~  ttt  |dwoo@@@|    ",
        "   ~  ttt  |rrroooC|b   ",
        "   ~~~~+~~~|----gg-|b   ",
        "   ttttttttttttttttt    ",
        "   ttttttttttttttttt    "
      ],
      "palettes": [ "standard_domestic_palette" ],
      "terrain": {
        " ": "t_region_groundcover_urban",
        "|": "t_wall",
        "-": "t_wall",
        "_": "t_door_locked",
        "L": "t_door_b",
        "/": "t_door_o",
        "I": "t_door_c",
        "t": "t_thconc_floor",
        "f": "t_window_frame",
        "g": "t_window_domestic",
        "o": "t_floor",
        "z": "t_sidewalk",
        "C": "t_grass",
        "~": "t_fence",
        "+": "t_fencegate_c"
      },
      "furniture": { "p": "f_toilet", "b": "f_dumpster", "N": "f_TV_antenna" },
      "place_monsters": [
        { "monster": "GROUP_PEST", "chance": 2, "repeat": [ 3, 6 ], "x": [ 18, 12 ], "y": [ 14, 20 ] },
        { "monster": "GROUP_PEST", "chance": 1, "repeat": [ 2, 3 ], "x": [ 14, 18 ], "y": [ 10, 12 ] },
        { "monster": "GROUP_FOREST", "chance": 4, "repeat": [ 1, 2 ], "x": [ 4, 9 ], "y": [ 4, 9 ] }
      ],
      "place_loot": [
        { "group": "drugs_misc", "chance": 40, "repeat": [ 1, 2 ], "x": [ 18, 18 ], "y": [ 12, 12 ] },
        { "group": "trash_forest", "chance": 100, "repeat": [ 3, 5 ], "x": [ 10, 14 ], "y": [ 17, 20 ] },
        { "group": "trash_forest", "chance": 85, "repeat": [ 1, 2 ], "x": [ 12, 14 ], "y": [ 14, 15 ] },
        { "group": "trash_forest", "chance": 85, "repeat": [ 1, 2 ], "x": [ 15, 16 ], "y": [ 17, 18 ] },
        { "group": "trash_forest", "chance": 85, "repeat": [ 1, 2 ], "x": [ 7, 4 ], "y": [ 15, 15 ] },
        { "group": "trash_forest", "chance": 85, "repeat": [ 1, 2 ], "x": [ 4, 4 ], "y": [ 14, 15 ] },
        { "group": "trash_forest", "chance": 85, "repeat": [ 1, 2 ], "x": [ 5, 5 ], "y": [ 4, 5 ] },
        { "group": "trash_forest", "chance": 85, "repeat": [ 1, 2 ], "x": [ 7, 8 ], "y": [ 4, 5 ] },
        { "group": "floor_trash", "chance": 85, "repeat": [ 1, 2 ], "x": [ 6, 9 ], "y": [ 7, 8 ] },
        { "group": "floor_trash", "chance": 85, "repeat": [ 1, 2 ], "x": [ 11, 12 ], "y": [ 4, 6 ] },
        { "group": "floor_trash", "chance": 85, "repeat": [ 1, 2 ], "x": [ 11, 12 ], "y": [ 7, 9 ] },
        { "group": "floor_trash", "chance": 85, "repeat": [ 1, 2 ], "x": [ 11, 12 ], "y": [ 10, 12 ] },
        { "group": "floor_trash", "chance": 85, "repeat": [ 1, 2 ], "x": [ 8, 8 ], "y": [ 9, 11 ] },
        { "group": "floor_trash", "chance": 85, "repeat": [ 1, 2 ], "x": [ 12, 14 ], "y": [ 10, 10 ] },
        { "group": "dining", "chance": 100, "repeat": [ 1, 4 ], "x": [ 5, 8 ], "y": [ 12, 14 ] },
        { "group": "bed", "chance": 100, "repeat": [ 1, 2 ], "x": [ 16, 17 ], "y": [ 19, 20 ] },
        { "group": "dresser", "chance": 80, "repeat": [ 1, 2 ], "x": [ 18, 18 ], "y": [ 20, 20 ] },
        { "group": "dresser", "chance": 80, "repeat": [ 1, 2 ], "x": [ 15, 15 ], "y": [ 20, 20 ] },
        { "group": "dresser", "chance": 80, "repeat": [ 1, 2 ], "x": [ 19, 19 ], "y": [ 6, 6 ] },
        { "group": "bed", "chance": 100, "repeat": [ 1, 2 ], "x": [ 19, 18 ], "y": [ 4, 4 ] },
        { "group": "book_school", "chance": 50, "repeat": [ 1, 2 ], "x": [ 14, 16 ], "y": [ 8, 8 ] },
        { "group": "book_school", "chance": 50, "repeat": [ 1, 2 ], "x": [ 17, 18 ], "y": [ 8, 8 ] },
        { "group": "toy_store", "chance": 70, "repeat": [ 1, 2 ], "x": [ 14, 14 ], "y": [ 4, 4 ] },
        { "group": "toy_store", "chance": 70, "repeat": [ 1, 2 ], "x": [ 15, 15 ], "y": [ 4, 4 ] },
        { "group": "trash_forest", "chance": 85, "repeat": [ 1, 2 ], "x": [ 5, 8 ], "y": [ 17, 19 ] },
        { "group": "magazines", "chance": 85, "repeat": [ 1, 2 ], "x": [ 16, 17 ], "y": [ 14, 14 ] },
        { "group": "magazines", "chance": 70, "repeat": [ 1, 2 ], "x": [ 18, 18 ], "y": [ 14, 14 ] },
        { "group": "trash_forest", "chance": 85, "repeat": [ 1, 2 ], "x": [ 5, 8 ], "y": [ 1, 2 ] },
        { "group": "trash_cart", "chance": 80, "repeat": [ 1, 2 ], "x": [ 4, 4 ], "y": [ 9, 6 ] },
        { "group": "trash_cart", "chance": 80, "repeat": [ 1, 2 ], "x": [ 7, 7 ], "y": [ 9, 9 ] }
      ]
    }
  }
]
