[
  {
    "type": "mapgen",
    "method": "json",
    "om_terrain": "permian_nesting_ground",
    "weight": 1000,
    "object": {
      "fill_ter": "t_region_groundcover",
      "rows": [
        "........................",
        "........................",
        "........................",
        "........................",
        ".....r.............r....",
        "....r.............r.....",
        "......,...,...,.........",
        ".........,...,...,......",
        "........,...,...,.......",
        ".......,...,...,........",
        "......,..;,...;.........",
        ".........,.;;,...,......",
        "........,..;;...,.......",
        ".......,.;.,..;,........",
        "......,...,...,.........",
        ".........,...,...,......",
        "........,...,...,.......",
        ".......,...,...,........",
        "....r.............r.....",
        ".....r.............r....",
        "........................",
        "........................",
        "........................",
        "........................"
      ],
      "terrain": { ".": "t_region_groundcover", ",": "t_region_soil", ";": "t_pit_shallow", "r": "t_region_shrub" },
      "place_item": [
        { "item": "permian_egg_large", "x": [ 10, 13 ], "y": [ 10, 13 ], "amount": [ 1, 2 ], "repeat": [ 2, 4 ], "chance": 85 },
        {
          "item": "permian_eggshell_fragments",
          "x": [ 8, 15 ],
          "y": [ 8, 15 ],
          "amount": [ 1, 2 ],
          "repeat": [ 4, 8 ],
          "chance": 100
        },
        {
          "item": "permian_hide_strip",
          "x": [ 8, 15 ],
          "y": [ 8, 15 ],
          "amount": [ 1, 2 ],
          "repeat": [ 1, 3 ],
          "chance": 35
        },
        { "item": "bone", "x": [ 7, 16 ], "y": [ 7, 16 ], "amount": [ 1, 2 ], "repeat": [ 1, 3 ], "chance": 25 }
      ],
      "place_monster": [
        { "group": "GROUP_PERMIAN_LIGHT_HERBIVORES", "x": [ 7, 16 ], "y": [ 7, 16 ], "repeat": [ 1, 2 ], "chance": 70 },
        {
          "monster": "mon_edaphosaurus_hatchling",
          "x": [ 10, 13 ],
          "y": [ 10, 13 ],
          "repeat": [ 1, 2 ],
          "chance": 60
        },
        { "monster": "mon_casea_young", "x": [ 9, 14 ], "y": [ 9, 14 ], "repeat": [ 1, 2 ], "chance": 45 }
      ],
      "place_loot": [
        { "group": "permian_loot_nesting_ground", "x": [ 8, 15 ], "y": [ 8, 15 ], "chance": 85 },
        { "group": "permian_loot_expedition_remains", "x": [ 5, 18 ], "y": [ 5, 18 ], "chance": 6 }
      ]
    }
  },
  {
    "type": "mapgen",
    "method": "json",
    "om_terrain": "permian_river_nest",
    "weight": 1000,
    "object": {
      "fill_ter": "t_region_groundcover",
      "rows": [
        "~~~~~~~~~~~~~~~~~~~~~~~~",
        "~~~~~~~~~~~~~~~~~~~~~~~~",
        "~~~~~~~~~~~~~~~~~~~~~~~~",
        "~~~~~~~~~~~~~~~~~~~~~~~~",
        "~~~~~~~~~~~~~~~~~~~~~~~~",
        "~~~~~~~~~~~~~~~~~~~~~~~~",
        "~~~~~~~~~~~~~~~~~~~~~~~~",
        "~~~~~~~~~~~~~~~~~~~~~~~~",
        ",,,,,,,,~~~~~~~~,,,,,,,,",
        ",,,,,,,,~~~~~~~~,,,,,,,,",
        ",,,,,,,,~~~~~~~~,,,,,,,,",
        ",,,,,,,,,,,,,,,,,,,,,,,,",
        ",,,,,,,,,,;;;;,,,,,,,,,,",
        "..r....r...;;....r....r.",
        ".r....r....r....r....r..",
        "r....r....r....r....r...",
        "....r....r....r....r....",
        "...r....r....r....r....r",
        "..r....r....r....r....r.",
        ".r....r....r....r....r..",
        "r....r....r....r....r...",
        "....r....r....r....r....",
        "...r....r....r....r....r",
        "..r....r....r....r....r."
      ],
      "terrain": { ".": "t_region_groundcover", ",": "t_region_soil", ";": "t_pit_shallow", "r": "t_region_shrub", "~": "t_water_sh" },
      "place_item": [
        {
          "item": "permian_egg_aquatic",
          "x": [ 10, 13 ],
          "y": [ 11, 14 ],
          "amount": [ 1, 2 ],
          "repeat": [ 2, 4 ],
          "chance": 90
        },
        {
          "item": "permian_eggshell_fragments",
          "x": [ 9, 14 ],
          "y": [ 11, 15 ],
          "amount": [ 1, 2 ],
          "repeat": [ 3, 6 ],
          "chance": 100
        },
        {
          "item": "permian_amphibian_skin",
          "x": [ 8, 15 ],
          "y": [ 12, 16 ],
          "amount": 1,
          "repeat": [ 1, 2 ],
          "chance": 20
        }
      ],
      "place_monster": [
        { "group": "GROUP_PERMIAN_RIVERBANK", "x": [ 8, 15 ], "y": [ 9, 16 ], "repeat": [ 1, 2 ], "chance": 70 },
        { "monster": "mon_mesosaurus_hatchling", "x": [ 9, 14 ], "y": [ 10, 13 ], "repeat": [ 2, 4 ], "chance": 65 },
        { "monster": "mon_eryops_young", "x": [ 9, 14 ], "y": [ 12, 16 ], "repeat": [ 1, 2 ], "chance": 40 }
      ],
      "place_loot": [ { "group": "permian_loot_riverbank", "x": [ 8, 15 ], "y": [ 10, 16 ], "chance": 90 } ]
    }
  },
  {
    "type": "mapgen",
    "method": "json",
    "om_terrain": "permian_bone_field",
    "weight": 1000,
    "object": {
      "fill_ter": "t_region_soil",
      "rows": [
        "r..........r..........r.",
        ".,,,,,,.,,r,,,.,,,,,,r,,",
        ".,,,,,,.,r,,,,.,,,,,r.,,",
        ".,,,,,,.r,,,,,.,,,,r,.,,",
        ".,,,,,,r,,,,,,.,,,r,,.,,",
        ".,,,,,r.,,,,,,.,,r,,,.,,",
        ".,,,,r;;,,,,,,.,r,,,,.,,",
        "....r..........;;.......",
        ".,,r,,,.,,,,,,r,,,,,,.,,",
        ".,r,,,,.,,,,,r.,,,,,,.,,",
        ".r,,,,,.,,,,r,.,,,,,,.,r",
        "r,,,,,,.,,,r,,.,,,,,,.r,",
        ".,,,,,,.,,r,,,.,,,,,,r,,",
        ".,,,,,,.,r,,,,.,,,,,r.,,",
        "........r..........r....",
        ".,,,,,,r,,;;,,.,,,r,,.,,",
        ".,,,,,r.,,,,,,.,,r,,,.,,",
        ".,,,,r,.,,,,,,.,r;;,,.,,",
        ".,,,r,,.,,,,,,.r,,,,,.,,",
        ".,,r,,,.,,,,,,r,,,,,,.,,",
        ".,r,,,,.,,,,,r.,,,,,,.,,",
        ".r..........r..........r",
        "r,,,,,,.,,,r,,.,,,,,,.r,",
        ".,,,,,,.,,r,,,.,,,,,,r,,"
      ],
      "terrain": { ".": "t_region_groundcover", ",": "t_region_soil", ";": "t_pit_shallow", "r": "t_region_shrub" },
      "place_item": [
        { "item": "bone", "x": [ 5, 18 ], "y": [ 5, 18 ], "amount": [ 2, 5 ], "repeat": [ 4, 8 ], "chance": 100 },
        {
          "item": "permian_skull_plate",
          "x": [ 6, 17 ],
          "y": [ 6, 17 ],
          "amount": [ 1, 2 ],
          "repeat": [ 2, 5 ],
          "chance": 65
        },
        { "item": "permian_fang", "x": [ 7, 16 ], "y": [ 7, 16 ], "amount": 1, "repeat": [ 1, 3 ], "chance": 35 },
        {
          "item": "permian_hide_strip",
          "x": [ 7, 16 ],
          "y": [ 7, 16 ],
          "amount": 1,
          "repeat": [ 1, 2 ],
          "chance": 30
        }
      ],
      "place_monster": [
        { "group": "GROUP_PERMIAN_SMALL_SCAVENGERS", "x": [ 6, 17 ], "y": [ 6, 17 ], "repeat": [ 2, 4 ], "chance": 85 },
        { "monster": "mon_youngina", "x": [ 8, 15 ], "y": [ 8, 15 ], "repeat": [ 1, 2 ], "chance": 35 }
      ],
      "place_loot": [
        { "group": "permian_loot_bone_field", "x": [ 5, 18 ], "y": [ 5, 18 ], "chance": 100 },
        { "group": "permian_loot_predator_den", "x": [ 8, 15 ], "y": [ 8, 15 ], "chance": 18 }
      ]
    }
  },
  {
    "type": "mapgen",
    "method": "json",
    "om_terrain": "permian_predator_den",
    "weight": 1000,
    "object": {
      "fill_ter": "t_region_groundcover",
      "rows": [
        "........................",
        "........................",
        "........................",
        "...r.....r.....r........",
        "........r.....r.....r...",
        ".......r.....r.....r....",
        "......r.....r.....r.....",
        ".....r.,,,,r,,,,,r......",
        "....r..,,,r,,,,,r.......",
        "...r...,,r,,,,,r,.......",
        ".......,r,;;;;r,,...r...",
        ".......r,,,;;r,,,..r....",
        "......r,,,,;;,,,,.r.....",
        ".....r.,,,;;;;,,,r......",
        "....r..,,,r,,,,,r.......",
        "...r...,,r,,,,,r,.......",
        ".......,r,,,,,r,,...r...",
        ".......r.....r.....r....",
        "......r.....r.....r.....",
        ".....r.....r.....r......",
        "....r.....r.....r.......",
        "........................",
        "........................",
        "........................"
      ],
      "terrain": { ".": "t_region_groundcover", ",": "t_region_soil", ";": "t_pit_shallow", "r": "t_region_shrub" },
      "place_item": [
        { "item": "bone", "x": [ 9, 14 ], "y": [ 9, 14 ], "amount": [ 2, 4 ], "repeat": [ 2, 4 ], "chance": 100 },
        {
          "item": "permian_fang",
          "x": [ 9, 14 ],
          "y": [ 9, 14 ],
          "amount": [ 1, 2 ],
          "repeat": [ 1, 3 ],
          "chance": 70
        },
        {
          "item": "permian_skull_plate",
          "x": [ 10, 13 ],
          "y": [ 10, 13 ],
          "amount": 1,
          "repeat": [ 1, 2 ],
          "chance": 55
        },
        {
          "item": "permian_sail_membrane",
          "x": [ 10, 13 ],
          "y": [ 10, 13 ],
          "amount": 1,
          "repeat": [ 1, 2 ],
          "chance": 25
        }
      ],
      "place_monster": [
        { "group": "GROUP_PERMIAN_APEX_PREDATORS", "x": [ 8, 15 ], "y": [ 8, 15 ], "repeat": [ 1, 2 ], "chance": 70 },
        { "monster": "mon_dimetrodon_juvenile", "x": [ 10, 13 ], "y": [ 10, 13 ], "repeat": [ 1, 2 ], "chance": 45 },
        { "monster": "mon_youngina_hatchling", "x": [ 10, 13 ], "y": [ 10, 13 ], "repeat": [ 1, 2 ], "chance": 35 }
      ],
      "place_loot": [ { "group": "permian_loot_predator_den", "x": [ 9, 14 ], "y": [ 9, 14 ], "chance": 100 } ]
    }
  },
  {
    "type": "mapgen",
    "method": "json",
    "om_terrain": "permian_badlands_basin",
    "weight": 1000,
    "object": {
      "fill_ter": "t_region_soil",
      "rows": [
        ",,,,,,,,,,,,,,,,,,,,,,,,",
        ",,,,,,,,,,,,,,,,,,,,,,,,",
        ",,,,,,,,,,,,,,,,,,,,,,,,",
        ",,,,,,,.,,,,.,,,,.,,,,,,",
        ",,,,,,.,,,,.,,,,.,,,,,,,",
        ",,,,,.;,,,.,,,,.,,,,.,,,",
        ",,,,.,,,,.,,,,.,,;,.,,,,",
        ",,,.,,,,.,,,,.,,,,.,,,,,",
        ",,,,,,,.,,,,.,,,,.,,,,,,",
        ",,,,r,.,,,,.,,,,.,,r,,,,",
        ",,,,,.,,,,.,,,,.,,,,.,,,",
        ",,,,.,,,,.,;;,.,,,,.,,,,",
        ",,,.,,,,.,,;;.,,,,.,,,,,",
        ",,,,,,,.,,,,.,,,,.,,,,,,",
        ",,,,,,.,,,,.,,,,.,,,,,,,",
        ",,,,,.,,,,.,,,,.,,,,.,,,",
        ",,,,.,,,,.,,,,.,,,,.,,,,",
        ",,,.,,,,;,,,,.,,,,.,,,,,",
        ",,,,,,,.,,,,.,,;,.,,,,,,",
        ",,,,,,.,,,,.,,,,.,,,,,,,",
        ",,,,,.,r,,.,,,,.r,,,.,,,",
        ",,,,,,,,,,,,,,,,,,,,,,,,",
        ",,,,,,,,,,,,,,,,,,,,,,,,",
        ",,,,,,,,,,,,,,,,,,,,,,,,"
      ],
      "terrain": { ".": "t_region_groundcover", ",": "t_region_soil", ";": "t_pit_shallow", "r": "t_region_shrub" },
      "place_item": [
        { "item": "bone", "x": [ 5, 18 ], "y": [ 5, 18 ], "amount": [ 1, 3 ], "repeat": [ 3, 6 ], "chance": 80 },
        {
          "item": "permian_scute_plate",
          "x": [ 7, 16 ],
          "y": [ 7, 16 ],
          "amount": [ 1, 2 ],
          "repeat": [ 2, 4 ],
          "chance": 50
        },
        {
          "item": "permian_hide_strip",
          "x": [ 7, 16 ],
          "y": [ 7, 16 ],
          "amount": [ 1, 2 ],
          "repeat": [ 1, 3 ],
          "chance": 40
        }
      ],
      "place_monster": [
        { "group": "GROUP_PERMIAN_DRY_BADLANDS", "x": [ 6, 17 ], "y": [ 6, 17 ], "repeat": [ 2, 4 ], "chance": 90 },
        { "group": "GROUP_PERMIAN_RARE_MEGAFAUNA", "x": [ 9, 14 ], "y": [ 9, 14 ], "repeat": 1, "chance": 20 }
      ],
      "place_loot": [
        { "group": "permian_loot_badlands", "x": [ 6, 17 ], "y": [ 6, 17 ], "chance": 95 },
        { "group": "permian_loot_expedition_remains", "x": [ 7, 16 ], "y": [ 7, 16 ], "chance": 10 }
      ]
    }
  },
  {
    "type": "mapgen",
    "method": "json",
    "om_terrain": "permian_rocky_upland",
    "weight": 1000,
    "object": {
      "fill_ter": "t_region_groundcover",
      "rows": [
        "rrrrrrrrrrrrrrrrrrrrrrrr",
        "r..,...,...,.r.,...,...,",
        "r.,...,...,..r,...,...,.",
        "r,...,...,...r...,...,..",
        "r...,...,...,r..,...,...",
        "r..,.;.,...,.r.,...,...,",
        "r.,...,...,..r,...;...,.",
        "r,...,...,...r...,...,..",
        "r...,...,...,r..,...,...",
        "r..,...,...,;r.,...,...,",
        "r.,...,...,.;r,...,...,.",
        "r,...,...,..;;;..,...,..",
        "r...,...,...,r..,...,...",
        "rrrrrrrrrrrrrrrrrrrrrrrr",
        "r.,...,;..,..r,...,...,.",
        "r,...,...,...r.;.,...,..",
        "r...,...,...,r..,...,...",
        "r..,...,...,.r.,...,...,",
        "r.,...,...,..r,...,...,.",
        "r,...,...,...r...,...,..",
        "r...,...,...,r..,...,...",
        "r..,...,...,.r.,...,...,",
        "r.,...,...,..r,...,...,.",
        "r,...,...,...r...,...,.."
      ],
      "terrain": { ".": "t_region_groundcover", ",": "t_region_soil", ";": "t_pit_shallow", "r": "t_region_shrub" },
      "place_item": [
        { "item": "bone", "x": [ 6, 17 ], "y": [ 6, 17 ], "amount": [ 1, 2 ], "repeat": [ 2, 4 ], "chance": 55 },
        { "item": "permian_fang", "x": [ 8, 15 ], "y": [ 8, 15 ], "amount": 1, "repeat": [ 1, 2 ], "chance": 25 },
        {
          "item": "permian_scale_patch",
          "x": [ 8, 15 ],
          "y": [ 8, 15 ],
          "amount": [ 1, 2 ],
          "repeat": [ 1, 3 ],
          "chance": 30
        }
      ],
      "place_monster": [
        { "group": "GROUP_PERMIAN_ROCKY_UPLANDS", "x": [ 6, 17 ], "y": [ 6, 17 ], "repeat": [ 2, 4 ], "chance": 90 },
        { "monster": "mon_youngina", "x": [ 8, 15 ], "y": [ 8, 15 ], "repeat": [ 1, 2 ], "chance": 35 }
      ],
      "place_loot": [
        { "group": "permian_loot_rocky_upland", "x": [ 6, 17 ], "y": [ 6, 17 ], "chance": 90 },
        { "group": "permian_loot_expedition_remains", "x": [ 8, 15 ], "y": [ 8, 15 ], "chance": 8 }
      ]
    }
  }
]
