[
  {
    "type": "mapgen",
    "method": "json",
    "om_terrain": [ "brit_raf_airfield" ],
    "object": {
      "fill_ter": "t_pavement",
      "rows": [
        "........................",
        "........................",
        "....|---|---|---|---....",
        "....|...|...|...|...|-D-",
        "....|...|...|...|...|...",
        "....|...|...|...|...|...",
        "....|---|---|---|---|...",
        "........................",
        "........................",
        "....|---|-------|---....",
        "....|.............|...D.",
        "....|.....&.......|.....",
        "....|.............|.....",
        "....|.............|.....",
        "....|----D-------|.....",
        "........................",
        "........................",
        "....|---|-------|---....",
        "....|.............|...D.",
        "....|.....&.......|.....",
        "....|.............|.....",
        "....|.............|.....",
        "....|----D-------|.....",
        "........................"
      ],
      "palettes": [ "standard_domestic_palette" ],
      "terrain": { ".": [ "t_pavement", "t_pavement", "t_pavement", "t_pavement_y" ], "D": "t_door_metal_locked" },
      "furniture": { "&": "f_table" },
      "place_loot": [
        { "group": "brit_military_clothing_locker", "x": [ 5, 7 ], "y": [ 3, 5 ], "chance": 70, "repeat": [ 2, 3 ] },
        { "group": "brit_military_clothing_locker", "x": [ 9, 11 ], "y": [ 3, 5 ], "chance": 70, "repeat": [ 2, 3 ] },
        { "group": "brit_military_clothing_locker", "x": [ 13, 15 ], "y": [ 3, 5 ], "chance": 70, "repeat": [ 2, 3 ] },
        { "group": "brit_military_clothing_locker", "x": [ 17, 19 ], "y": [ 3, 5 ], "chance": 70, "repeat": [ 2, 3 ] },
        { "group": "office", "x": [ 10, 12 ], "y": [ 11, 11 ], "chance": 80, "repeat": [ 1, 2 ] },
        { "group": "office", "x": [ 10, 12 ], "y": [ 19, 19 ], "chance": 80, "repeat": [ 1, 2 ] },
        { "group": "brit_military_basic", "x": [ 5, 19 ], "y": [ 10, 13 ], "chance": 50, "repeat": [ 2, 4 ] },
        { "group": "brit_military_basic", "x": [ 5, 19 ], "y": [ 18, 21 ], "chance": 50, "repeat": [ 2, 4 ] }
      ],
      "place_vehicles": [ { "vehicle": "military_vehicles", "x": 12, "y": 3, "chance": 70, "rotation": 270 } ],
      "place_npcs": [
        { "class": "brit_raf_pilot", "x": 10, "y": 11 },
        { "class": "brit_raf_pilot", "x": 10, "y": 19 },
        { "class": "brit_soldier", "x": 18, "y": 11 },
        { "class": "brit_soldier", "x": 18, "y": 19 },
        { "class": "brit_officer", "x": 6, "y": 11 }
      ]
    }
  }
]
